1111111111111
10E00000000C1
1110011110001
1P00110000001
111111111111
