1111111111111
10E00000000C1
1010011110001
1P10110000001
1111111111111
